NO ./textures/north.xpm
SO ./textures/south.xpm
WE ./textures/west.xpm
EA ./textures/east.xpm

F 220,100,0
C 225,30,0

1111111111111111111111111111
11111111111111NSWE1111111111
1P11111111111111111111111111
11111111111111111111111111
11111111 111111  11111111111