NO ./textures/north.xpm
SO ./textures/south.xpm
WE ./textures/west.xpm
EA ./textures/east.xpm

F 65, 128, 78
C 184, 255, 250

11111
10N01
10001
11111