NO ./textures/north.xpm
SO ./textures/south.xpm
WE ./textures/west.xpm
EA ./textures/east.xpm

F 65, 128, 78
C 184, 255, 250

11111111111
11 11N00011
11 11000011
11 110000111111
11 1111111	111
1111111111111111