NO ./textures/north.xpm
SO ./textures/south.xpm
WE ./textures/west.xpm
EA ./textures/east.xpm

F 255,255,255
C 0,0,0

111111
  1011
110101   
101 111 
1001011
111111  