NO ./textures/north.xpm
SO ./textures/south.xpm
WE ./textures/west.xpm
EA ./textures/east.xpm

F 65, 128, 78
C 184, 255, 250

11111
100001
100001
100001
100001
100001
100001
100N01
100001
100001
111111