NO ./textures/north.xpm
SO ./textures/south.xpm
WE ./textures/west.xpm
EA ./textures/east.xpm

F 65, 128, 78
C 184, 255, 250

1111
1W01
1001
1111