NO ./textures/north.xpm
SO ./textures/south.xpm
WE ./textures/west.xpm
EA ./textures/east.xpm

F 65, 128, 78
C 184, 255, 250

			1111111111111111111111111111111111111111111111111111111111111111111111
			100000000000000	00000000000000000000000000000000000000000001111111111111
			10000000000000000000000000000000000000000000000000000000000011111111111
111111111111100000000000000000000000000000000000000000000000001111111111
111111111011000001110000000111111111111111111111111111111111111111111
111101111111111101110000001110001111
1111011	1	11110111011100100000111
111101111111111101110111001000001111
1100000011010100011100000010000011111111111111111111111
1000000000000000000000000000000000000000000000000000011
100000011111111100000000000000000000000000000000W000011
100000011     11000000000000000000000000000000000000011
1000000111111111000000000000000000000000000000000000011
1000000000000000000101001000001111111111111111111111111
1000000000000000110101001000001111
1000000000000000110101001000001111
1000000000000000110101001000001111
1100000111111111111101111000001111
111111111111111111111111111111
