NO ./textures/north.xpm
SO ./textures/south.xpm
WE ./textures/west.xpm
EA ./textures/east.xpm

F 65, 128, 78
C 184, 255, 250

1111111111111111111111111111111111111111111111111111111111111111111111
10000000000000000000000000000000000000000000000000000000001111111111111
10000000000000000000000000000000000000000000000000000000000011111111111
11111000000000000000000000000000000000000000000000000000000001111111111
111111111011000001110000000111111111111111111111111111111111111111111
111101111111110001110000001110001111
111101111111110001110111001000001111
111101111111110001110111001000001111
11000000110101000111000000100000111111111111111111111111111
10000000000000000000000000000000000000000000000000000000011
1000000111111111000000000000000000000000000000000000E000011
10000001111111110000000000000000000000000000000000000000011
10000001111111110000000000000000000000000000000000000000011
10000000000000000001010010000011111111111111111111111111111
1000000000000000110101001000001111
1000000000000000110101001000001111
1000000000000000110101001000001111
1100000111111111111101111000001111
111111111111111111111111111111
