NO ./textures/north.xpm
SO ./textures/south.xpm
WE ./textures/west.xpm
EA ./textures/east.xpm

F 65, 128, 78
C 184, 255, 250

          1111111111111111111
1111111111100000000000011111
1000000001110000000000001   11
11111000000000000000000011111111
111111111011000001110000000111111
11111000001110000111011111111111
11110111111 1101110000001000001
1111011111111101110101001000001
1100000011010101110000001000001
1000000000001000110000001000001
1000000000000000110101001000001
11000001110101011111011110N000111
11110111 1110101 10111101000001
11110111 1110101 10111101000001
11110111 1110101 10111101000001
11110111 1110101 10111101000001
11110111 1110101 10111101000001
11110111 1110101 10111101000001
11110111 1110101 10111101000001
11111111 111111  1111111111111