NO ./textures/north.xpm
SO ./textures/south.xpm
WE ./textures/west.xpm
EA ./textures/east.xpm

F 65, 128, 78
C 184, 255, 250


1111111111111111111111
1000000000000000000001
100E000000000011111111
1000000000000011111111
1111111110000001100001111
11	11111110000001100001
11111111000011001100001111
1000011000011001100001
1000011000011001111101
1000011000011001111101
1000000000011000000001
1111111111111111111111