NO ./textures/north.xpm
SO ./textures/south.xpm
WE ./textures/west.xpm
EA ./textures/east.xpm

F 65, 128, 78
C 184, 255, 250

11111111111111111111111111111111111
11110111110000000000001111111111111
10000000011100000000000011111111111
1111100000000000000000001111111111
1111111110110000011100000001111111
111110000011100001110111110111111
1111011111111101110000001000001111
1111011111111101110101001000001111
1100000011010101110000001000001
1000000000001000110000001000001111
1000000000000000110101001000001111
1000000000000000110101001000001111
1000000000000000110101001000001111
1000000000000000110101001000001111
1000000000000000110101001000001111
1000000000000000110101001000001111
1000000000000000110101001000001111
1000000000000000110101001000001111
1000000000000000110101001000001111
1000000000000000110101001000001111
1000000000000000110101001000001111
1000000000000000110101001000001111
1000000000000000110101001000001111
1000000000000000110101001000001111
1000000000000000110101001000001111
1000000000000000110101001000001111
1000000000000000110101001000001111
11000001111101011111011110N0001111
11110111 1110101 10111101000001
11110111 1110101 10111101000001
11110111 1110101 10111101000001
11110111 1110101 10111101000001
11110111 1110101 10111101000001
11110111 1110101 10111101000001
11110111 1110101 10111101001001
11111111 111111  1111111111 111
111111111111111111111111
