NO ./textures/north.xpm
SO ./textures/south.xpm
EA ./textures/east.xpm

WE ./textures/west.xpm

F 255,236,168

C 29,0,92

          1111111111111111111
111111111101100000000000011111
1000000001110000000000001   11
11111000000000000000000011111111
111111111011000001110000000111111
11111000001110000111011111111111
11110111111 11011100000010001
11110111111111011101010010001
11000000110101011100000010001
10000000000010001100000010001
10000000000000001101010010001
11000001110101011111011110N0111
11110111 1110101 101111010001
11111111 111111  11111111111