NO ./textures/north.xpm
SO ./textures/south.xpm
WE ./textures/west.xpm
EA ./textures/east.xpm

F 38, 54, 51
C 242, 221, 191

   11111111111111111111111111111111111111111111111111
    10000000000000000111110000000000000000N001111101
    100000011110000000000000000000011110000000000001
    100011111111111111110011111111111111111111111001
 11110101              1001                 11  1001111
    100011111111111111111011111111111111111100111001
    100001110000000011111000000000001000000000000001
    100000000000000000000000001111000000011100000001
111111111111111111111111111111111111111111111111111111111
