

NO ./textures/north.xpm
SO ./textures/south.xpm
WE ./textures/west.xpm
EA ./textures/east.xpm

F 65, 

128,
111

C 184, 
255,
111


1111111111
1N00000001
1011111101
1011001101
1011001101
1111111111
1        1
1111111111
1011011101
1000000001
1111111111



